"filename", "language", "C++", "GLSL", "Markdown", "C", "comment", "blank", "total"
"/Users/goujiayuan/STUDY/图形学算法‼️/tiny-engine/TODO.md", "Markdown", 0, 0, 24, 0, 0, 37, 61
"/Users/goujiayuan/STUDY/图形学算法‼️/tiny-engine/main.cpp", "C++", 4, 0, 0, 0, 0, 2, 6
"/Users/goujiayuan/STUDY/图形学算法‼️/tiny-engine/resources/Shader参数说明.md", "Markdown", 0, 0, 23, 0, 0, 9, 32
"/Users/goujiayuan/STUDY/图形学算法‼️/tiny-engine/resources/shaders/gbuffer/gbuffer.frag", "GLSL", 0, 15, 0, 0, 0, 3, 18
"/Users/goujiayuan/STUDY/图形学算法‼️/tiny-engine/resources/shaders/gbuffer/gbuffer.vert", "GLSL", 0, 15, 0, 0, 0, 4, 19
"/Users/goujiayuan/STUDY/图形学算法‼️/tiny-engine/resources/shaders/skybox/skybox.frag", "GLSL", 0, 8, 0, 0, 0, 3, 11
"/Users/goujiayuan/STUDY/图形学算法‼️/tiny-engine/resources/shaders/skybox/skybox.vert", "GLSL", 0, 11, 0, 0, 0, 3, 14
"/Users/goujiayuan/STUDY/图形学算法‼️/tiny-engine/resources/shaders/universal shaders/normal/normal.frag", "GLSL", 0, 9, 0, 0, 0, 2, 11
"/Users/goujiayuan/STUDY/图形学算法‼️/tiny-engine/resources/shaders/universal shaders/normal/normal.vert", "GLSL", 0, 15, 0, 0, 0, 4, 19
"/Users/goujiayuan/STUDY/图形学算法‼️/tiny-engine/resources/shaders/universal shaders/reflect/reflect.frag", "GLSL", 0, 14, 0, 0, 0, 3, 17
"/Users/goujiayuan/STUDY/图形学算法‼️/tiny-engine/resources/shaders/universal shaders/reflect/reflect.vert", "GLSL", 0, 17, 0, 0, 0, 4, 21
"/Users/goujiayuan/STUDY/图形学算法‼️/tiny-engine/resources/shaders/universal shaders/texture/texture.frag", "GLSL", 0, 9, 0, 0, 0, 2, 11
"/Users/goujiayuan/STUDY/图形学算法‼️/tiny-engine/resources/shaders/universal shaders/texture/texture.vert", "GLSL", 0, 15, 0, 0, 0, 4, 19
"/Users/goujiayuan/STUDY/图形学算法‼️/tiny-engine/src/camera.h", "C++", 98, 0, 0, 0, 3, 20, 121
"/Users/goujiayuan/STUDY/图形学算法‼️/tiny-engine/src/debug.cpp", "C++", 21, 0, 0, 0, 0, 1, 22
"/Users/goujiayuan/STUDY/图形学算法‼️/tiny-engine/src/debug.h", "C++", 5, 0, 0, 0, 0, 3, 8
"/Users/goujiayuan/STUDY/图形学算法‼️/tiny-engine/src/fbo.h", "C++", 54, 0, 0, 0, 3, 14, 71
"/Users/goujiayuan/STUDY/图形学算法‼️/tiny-engine/src/imgui_manager.cpp", "C++", 25, 0, 0, 0, 0, 4, 29
"/Users/goujiayuan/STUDY/图形学算法‼️/tiny-engine/src/imgui_manager.h", "C++", 17, 0, 0, 0, 1, 7, 25
"/Users/goujiayuan/STUDY/图形学算法‼️/tiny-engine/src/main.cpp", "C++", 186, 0, 0, 0, 60, 62, 308
"/Users/goujiayuan/STUDY/图形学算法‼️/tiny-engine/src/model.cpp", "C++", 194, 0, 0, 0, 44, 56, 294
"/Users/goujiayuan/STUDY/图形学算法‼️/tiny-engine/src/model.h", "C++", 84, 0, 0, 0, 1, 20, 105
"/Users/goujiayuan/STUDY/图形学算法‼️/tiny-engine/src/shader.h", "C++", 190, 0, 0, 0, 28, 17, 235
"/Users/goujiayuan/STUDY/图形学算法‼️/tiny-engine/src/utils.cpp", "C++", 130, 0, 0, 0, 3, 17, 150
"/Users/goujiayuan/STUDY/图形学算法‼️/tiny-engine/src/utils.h", "C++", 45, 0, 0, 0, 3, 12, 60
"/Users/goujiayuan/STUDY/图形学算法‼️/tiny-engine/third_party/glad/README.md", "Markdown", 0, 0, 2, 0, 0, 1, 3
"/Users/goujiayuan/STUDY/图形学算法‼️/tiny-engine/third_party/glad/include/KHR/khrplatform.h", "C++", 117, 0, 0, 0, 165, 30, 312
"/Users/goujiayuan/STUDY/图形学算法‼️/tiny-engine/third_party/glad/include/glad/glad.h", "C++", 2093, 0, 0, 0, 20, 17, 2130
"/Users/goujiayuan/STUDY/图形学算法‼️/tiny-engine/third_party/glad/src/glad.c", "C", 0, 0, 0, 1069, 25, 47, 1141
"/Users/goujiayuan/STUDY/图形学算法‼️/tiny-engine/third_party/glfw/include/GLFW/glfw3.h", "C++", 600, 0, 0, 0, 5083, 250, 5933
"/Users/goujiayuan/STUDY/图形学算法‼️/tiny-engine/third_party/glfw/include/GLFW/glfw3native.h", "C++", 96, 0, 0, 0, 495, 44, 635
"/Users/goujiayuan/STUDY/图形学算法‼️/tiny-engine/third_party/glm/README.md", "Markdown", 0, 0, 2, 0, 0, 1, 3
"/Users/goujiayuan/STUDY/图形学算法‼️/tiny-engine/third_party/glm/include/glm/common.hpp", "C++", 97, 0, 0, 0, 389, 54, 540
"/Users/goujiayuan/STUDY/图形学算法‼️/tiny-engine/third_party/glm/include/glm/detail/_features.hpp", "C++", 110, 0, 0, 0, 185, 100, 395
"/Users/goujiayuan/STUDY/图形学算法‼️/tiny-engine/third_party/glm/include/glm/detail/_fixes.hpp", "C++", 16, 0, 0, 0, 5, 7, 28
"/Users/goujiayuan/STUDY/图形学算法‼️/tiny-engine/third_party/glm/include/glm/detail/_noise.hpp", "C++", 67, 0, 0, 0, 0, 15, 82
"/Users/goujiayuan/STUDY/图形学算法‼️/tiny-engine/third_party/glm/include/glm/detail/_swizzle.hpp", "C++", 704, 0, 0, 0, 55, 46, 805
"/Users/goujiayuan/STUDY/图形学算法‼️/tiny-engine/third_party/glm/include/glm/detail/_swizzle_func.hpp", "C++", 648, 0, 0, 0, 0, 35, 683
"/Users/goujiayuan/STUDY/图形学算法‼️/tiny-engine/third_party/glm/include/glm/detail/_vectorize.hpp", "C++", 142, 0, 0, 0, 0, 21, 163
"/Users/goujiayuan/STUDY/图形学算法‼️/tiny-engine/third_party/glm/include/glm/detail/compute_common.hpp", "C++", 43, 0, 0, 0, 1, 7, 51
"/Users/goujiayuan/STUDY/图形学算法‼️/tiny-engine/third_party/glm/include/glm/detail/compute_vector_relational.hpp", "C++", 16, 0, 0, 0, 12, 3, 31
"/Users/goujiayuan/STUDY/图形学算法‼️/tiny-engine/third_party/glm/include/glm/detail/func_common.inl", "C++", 638, 0, 0, 0, 43, 112, 793
"/Users/goujiayuan/STUDY/图形学算法‼️/tiny-engine/third_party/glm/include/glm/detail/func_common_simd.inl", "C++", 195, 0, 0, 0, 14, 23, 232
"/Users/goujiayuan/STUDY/图形学算法‼️/tiny-engine/third_party/glm/include/glm/detail/func_exponential.inl", "C++", 123, 0, 0, 0, 9, 21, 153
"/Users/goujiayuan/STUDY/图形学算法‼️/tiny-engine/third_party/glm/include/glm/detail/func_exponential_simd.inl", "C++", 30, 0, 0, 0, 2, 6, 38
"/Users/goujiayuan/STUDY/图形学算法‼️/tiny-engine/third_party/glm/include/glm/detail/func_geometric.inl", "C++", 193, 0, 0, 0, 17, 34, 244
"/Users/goujiayuan/STUDY/图形学算法‼️/tiny-engine/third_party/glm/include/glm/detail/func_geometric_simd.inl", "C++", 143, 0, 0, 0, 2, 19, 164
"/Users/goujiayuan/STUDY/图形学算法‼️/tiny-engine/third_party/glm/include/glm/detail/func_integer.inl", "C++", 308, 0, 0, 0, 11, 54, 373
"/Users/goujiayuan/STUDY/图形学算法‼️/tiny-engine/third_party/glm/include/glm/detail/func_integer_simd.inl", "C++", 52, 0, 0, 0, 0, 14, 66
"/Users/goujiayuan/STUDY/图形学算法‼️/tiny-engine/third_party/glm/include/glm/detail/func_matrix.inl", "C++", 347, 0, 0, 0, 0, 52, 399
"/Users/goujiayuan/STUDY/图形学算法‼️/tiny-engine/third_party/glm/include/glm/detail/func_matrix_simd.inl", "C++", 191, 0, 0, 0, 24, 35, 250
"/Users/goujiayuan/STUDY/图形学算法‼️/tiny-engine/third_party/glm/include/glm/detail/func_packing.inl", "C++", 144, 0, 0, 0, 2, 44, 190
"/Users/goujiayuan/STUDY/图形学算法‼️/tiny-engine/third_party/glm/include/glm/detail/func_packing_simd.inl", "C++", 5, 0, 0, 0, 0, 2, 7
"/Users/goujiayuan/STUDY/图形学算法‼️/tiny-engine/third_party/glm/include/glm/detail/func_trigonometric.inl", "C++", 145, 0, 0, 0, 14, 39, 198
"/Users/goujiayuan/STUDY/图形学算法‼️/tiny-engine/third_party/glm/include/glm/detail/func_trigonometric_simd.inl", "C++", 0, 0, 0, 0, 0, 1, 1
"/Users/goujiayuan/STUDY/图形学算法‼️/tiny-engine/third_party/glm/include/glm/detail/func_vector_relational.inl", "C++", 78, 0, 0, 0, 0, 10, 88
"/Users/goujiayuan/STUDY/图形学算法‼️/tiny-engine/third_party/glm/include/glm/detail/func_vector_relational_simd.inl", "C++", 5, 0, 0, 0, 0, 2, 7
"/Users/goujiayuan/STUDY/图形学算法‼️/tiny-engine/third_party/glm/include/glm/detail/glm.cpp", "C++", 198, 0, 0, 0, 17, 49, 264
"/Users/goujiayuan/STUDY/图形学算法‼️/tiny-engine/third_party/glm/include/glm/detail/qualifier.hpp", "C++", 196, 0, 0, 0, 1, 34, 231
"/Users/goujiayuan/STUDY/图形学算法‼️/tiny-engine/third_party/glm/include/glm/detail/setup.hpp", "C++", 861, 0, 0, 0, 108, 167, 1136
"/Users/goujiayuan/STUDY/图形学算法‼️/tiny-engine/third_party/glm/include/glm/detail/type_float.hpp", "C++", 51, 0, 0, 0, 3, 15, 69
"/Users/goujiayuan/STUDY/图形学算法‼️/tiny-engine/third_party/glm/include/glm/detail/type_half.hpp", "C++", 11, 0, 0, 0, 0, 6, 17
"/Users/goujiayuan/STUDY/图形学算法‼️/tiny-engine/third_party/glm/include/glm/detail/type_half.inl", "C++", 121, 0, 0, 0, 80, 41, 242
"/Users/goujiayuan/STUDY/图形学算法‼️/tiny-engine/third_party/glm/include/glm/detail/type_mat2x2.hpp", "C++", 120, 0, 0, 0, 11, 47, 178
"/Users/goujiayuan/STUDY/图形学算法‼️/tiny-engine/third_party/glm/include/glm/detail/type_mat2x2.inl", "C++", 465, 0, 0, 0, 9, 63, 537
"/Users/goujiayuan/STUDY/图形学算法‼️/tiny-engine/third_party/glm/include/glm/detail/type_mat2x3.hpp", "C++", 107, 0, 0, 0, 11, 42, 160
"/Users/goujiayuan/STUDY/图形学算法‼️/tiny-engine/third_party/glm/include/glm/detail/type_mat2x3.inl", "C++", 445, 0, 0, 0, 9, 57, 511
"/Users/goujiayuan/STUDY/图形学算法‼️/tiny-engine/third_party/glm/include/glm/detail/type_mat2x4.hpp", "C++", 109, 0, 0, 0, 11, 42, 162
"/Users/goujiayuan/STUDY/图形学算法‼️/tiny-engine/third_party/glm/include/glm/detail/type_mat2x4.inl", "C++", 455, 0, 0, 0, 9, 57, 521
"/Users/goujiayuan/STUDY/图形学算法‼️/tiny-engine/third_party/glm/include/glm/detail/type_mat3x2.hpp", "C++", 114, 0, 0, 0, 11, 43, 168
"/Users/goujiayuan/STUDY/图形学算法‼️/tiny-engine/third_party/glm/include/glm/detail/type_mat3x2.inl", "C++", 467, 0, 0, 0, 9, 57, 533
"/Users/goujiayuan/STUDY/图形学算法‼️/tiny-engine/third_party/glm/include/glm/detail/type_mat3x3.hpp", "C++", 127, 0, 0, 0, 11, 47, 185
"/Users/goujiayuan/STUDY/图形学算法‼️/tiny-engine/third_party/glm/include/glm/detail/type_mat3x3.inl", "C++", 528, 0, 0, 0, 9, 65, 602
"/Users/goujiayuan/STUDY/图形学算法‼️/tiny-engine/third_party/glm/include/glm/detail/type_mat3x4.hpp", "C++", 114, 0, 0, 0, 11, 42, 167
"/Users/goujiayuan/STUDY/图形学算法‼️/tiny-engine/third_party/glm/include/glm/detail/type_mat3x4.inl", "C++", 513, 0, 0, 0, 9, 57, 579
"/Users/goujiayuan/STUDY/图形学算法‼️/tiny-engine/third_party/glm/include/glm/detail/type_mat4x2.hpp", "C++", 119, 0, 0, 0, 11, 42, 172
"/Users/goujiayuan/STUDY/图形学算法‼️/tiny-engine/third_party/glm/include/glm/detail/type_mat4x2.inl", "C++", 509, 0, 0, 0, 9, 57, 575
"/Users/goujiayuan/STUDY/图形学算法‼️/tiny-engine/third_party/glm/include/glm/detail/type_mat4x3.hpp", "C++", 119, 0, 0, 0, 11, 42, 172
"/Users/goujiayuan/STUDY/图形学算法‼️/tiny-engine/third_party/glm/include/glm/detail/type_mat4x3.inl", "C++", 533, 0, 0, 0, 9, 57, 599
"/Users/goujiayuan/STUDY/图形学算法‼️/tiny-engine/third_party/glm/include/glm/detail/type_mat4x4.hpp", "C++", 132, 0, 0, 0, 11, 47, 190
"/Users/goujiayuan/STUDY/图形学算法‼️/tiny-engine/third_party/glm/include/glm/detail/type_mat4x4.inl", "C++", 598, 0, 0, 0, 36, 73, 707
"/Users/goujiayuan/STUDY/图形学算法‼️/tiny-engine/third_party/glm/include/glm/detail/type_mat4x4_simd.inl", "C++", 3, 0, 0, 0, 1, 3, 7
"/Users/goujiayuan/STUDY/图形学算法‼️/tiny-engine/third_party/glm/include/glm/detail/type_quat.hpp", "C++", 121, 0, 0, 0, 22, 44, 187
"/Users/goujiayuan/STUDY/图形学算法‼️/tiny-engine/third_party/glm/include/glm/detail/type_quat.inl", "C++", 321, 0, 0, 0, 29, 59, 409
"/Users/goujiayuan/STUDY/图形学算法‼️/tiny-engine/third_party/glm/include/glm/detail/type_quat_simd.inl", "C++", 117, 0, 0, 0, 55, 17, 189
"/Users/goujiayuan/STUDY/图形学算法‼️/tiny-engine/third_party/glm/include/glm/detail/type_vec1.hpp", "C++", 194, 0, 0, 0, 47, 68, 309
"/Users/goujiayuan/STUDY/图形学算法‼️/tiny-engine/third_party/glm/include/glm/detail/type_vec1.inl", "C++", 453, 0, 0, 0, 13, 86, 552
"/Users/goujiayuan/STUDY/图形学算法‼️/tiny-engine/third_party/glm/include/glm/detail/type_vec2.hpp", "C++", 285, 0, 0, 0, 21, 94, 400
"/Users/goujiayuan/STUDY/图形学算法‼️/tiny-engine/third_party/glm/include/glm/detail/type_vec2.inl", "C++", 779, 0, 0, 0, 13, 122, 914
"/Users/goujiayuan/STUDY/图形学算法‼️/tiny-engine/third_party/glm/include/glm/detail/type_vec3.hpp", "C++", 313, 0, 0, 0, 24, 96, 433
"/Users/goujiayuan/STUDY/图形学算法‼️/tiny-engine/third_party/glm/include/glm/detail/type_vec3.inl", "C++", 927, 0, 0, 0, 13, 129, 1069
"/Users/goujiayuan/STUDY/图形学算法‼️/tiny-engine/third_party/glm/include/glm/detail/type_vec4.hpp", "C++", 369, 0, 0, 0, 36, 101, 506
"/Users/goujiayuan/STUDY/图形学算法‼️/tiny-engine/third_party/glm/include/glm/detail/type_vec4.inl", "C++", 966, 0, 0, 0, 13, 162, 1141
"/Users/goujiayuan/STUDY/图形学算法‼️/tiny-engine/third_party/glm/include/glm/detail/type_vec4_simd.inl", "C++", 681, 0, 0, 0, 2, 93, 776
"/Users/goujiayuan/STUDY/图形学算法‼️/tiny-engine/third_party/glm/include/glm/exponential.hpp", "C++", 24, 0, 0, 0, 74, 13, 111
"/Users/goujiayuan/STUDY/图形学算法‼️/tiny-engine/third_party/glm/include/glm/ext.hpp", "C++", 227, 0, 0, 0, 3, 24, 254
"/Users/goujiayuan/STUDY/图形学算法‼️/tiny-engine/third_party/glm/include/glm/ext/matrix_clip_space.hpp", "C++", 137, 0, 0, 0, 336, 50, 523
"/Users/goujiayuan/STUDY/图形学算法‼️/tiny-engine/third_party/glm/include/glm/ext/matrix_clip_space.inl", "C++", 492, 0, 0, 0, 1, 63, 556
"/Users/goujiayuan/STUDY/图形学算法‼️/tiny-engine/third_party/glm/include/glm/ext/matrix_common.hpp", "C++", 14, 0, 0, 0, 14, 9, 37
"/Users/goujiayuan/STUDY/图形学算法‼️/tiny-engine/third_party/glm/include/glm/ext/matrix_common.inl", "C++", 14, 0, 0, 0, 0, 3, 17
"/Users/goujiayuan/STUDY/图形学算法‼️/tiny-engine/third_party/glm/include/glm/ext/matrix_double2x2.hpp", "C++", 7, 0, 0, 0, 11, 6, 24
"/Users/goujiayuan/STUDY/图形学算法‼️/tiny-engine/third_party/glm/include/glm/ext/matrix_double2x2_precision.hpp", "C++", 11, 0, 0, 0, 29, 10, 50
"/Users/goujiayuan/STUDY/图形学算法‼️/tiny-engine/third_party/glm/include/glm/ext/matrix_double2x3.hpp", "C++", 6, 0, 0, 0, 8, 5, 19
"/Users/goujiayuan/STUDY/图形学算法‼️/tiny-engine/third_party/glm/include/glm/ext/matrix_double2x3_precision.hpp", "C++", 8, 0, 0, 0, 17, 7, 32
"/Users/goujiayuan/STUDY/图形学算法‼️/tiny-engine/third_party/glm/include/glm/ext/matrix_double2x4.hpp", "C++", 6, 0, 0, 0, 8, 5, 19
"/Users/goujiayuan/STUDY/图形学算法‼️/tiny-engine/third_party/glm/include/glm/ext/matrix_double2x4_precision.hpp", "C++", 8, 0, 0, 0, 17, 7, 32
"/Users/goujiayuan/STUDY/图形学算法‼️/tiny-engine/third_party/glm/include/glm/ext/matrix_double3x2.hpp", "C++", 6, 0, 0, 0, 8, 5, 19
"/Users/goujiayuan/STUDY/图形学算法‼️/tiny-engine/third_party/glm/include/glm/ext/matrix_double3x2_precision.hpp", "C++", 8, 0, 0, 0, 17, 7, 32
"/Users/goujiayuan/STUDY/图形学算法‼️/tiny-engine/third_party/glm/include/glm/ext/matrix_double3x3.hpp", "C++", 7, 0, 0, 0, 11, 6, 24
"/Users/goujiayuan/STUDY/图形学算法‼️/tiny-engine/third_party/glm/include/glm/ext/matrix_double3x3_precision.hpp", "C++", 11, 0, 0, 0, 29, 10, 50
"/Users/goujiayuan/STUDY/图形学算法‼️/tiny-engine/third_party/glm/include/glm/ext/matrix_double3x4.hpp", "C++", 6, 0, 0, 0, 8, 5, 19
"/Users/goujiayuan/STUDY/图形学算法‼️/tiny-engine/third_party/glm/include/glm/ext/matrix_double3x4_precision.hpp", "C++", 8, 0, 0, 0, 17, 7, 32
"/Users/goujiayuan/STUDY/图形学算法‼️/tiny-engine/third_party/glm/include/glm/ext/matrix_double4x2.hpp", "C++", 6, 0, 0, 0, 8, 5, 19
"/Users/goujiayuan/STUDY/图形学算法‼️/tiny-engine/third_party/glm/include/glm/ext/matrix_double4x2_precision.hpp", "C++", 8, 0, 0, 0, 17, 7, 32
"/Users/goujiayuan/STUDY/图形学算法‼️/tiny-engine/third_party/glm/include/glm/ext/matrix_double4x3.hpp", "C++", 6, 0, 0, 0, 8, 5, 19
"/Users/goujiayuan/STUDY/图形学算法‼️/tiny-engine/third_party/glm/include/glm/ext/matrix_double4x3_precision.hpp", "C++", 8, 0, 0, 0, 17, 7, 32
"/Users/goujiayuan/STUDY/图形学算法‼️/tiny-engine/third_party/glm/include/glm/ext/matrix_double4x4.hpp", "C++", 7, 0, 0, 0, 11, 6, 24
"/Users/goujiayuan/STUDY/图形学算法‼️/tiny-engine/third_party/glm/include/glm/ext/matrix_double4x4_precision.hpp", "C++", 11, 0, 0, 0, 29, 10, 50
"/Users/goujiayuan/STUDY/图形学算法‼️/tiny-engine/third_party/glm/include/glm/ext/matrix_float2x2.hpp", "C++", 7, 0, 0, 0, 11, 6, 24
"/Users/goujiayuan/STUDY/图形学算法‼️/tiny-engine/third_party/glm/include/glm/ext/matrix_float2x2_precision.hpp", "C++", 11, 0, 0, 0, 29, 10, 50
"/Users/goujiayuan/STUDY/图形学算法‼️/tiny-engine/third_party/glm/include/glm/ext/matrix_float2x3.hpp", "C++", 6, 0, 0, 0, 8, 5, 19
"/Users/goujiayuan/STUDY/图形学算法‼️/tiny-engine/third_party/glm/include/glm/ext/matrix_float2x3_precision.hpp", "C++", 8, 0, 0, 0, 17, 7, 32
"/Users/goujiayuan/STUDY/图形学算法‼️/tiny-engine/third_party/glm/include/glm/ext/matrix_float2x4.hpp", "C++", 6, 0, 0, 0, 8, 5, 19
"/Users/goujiayuan/STUDY/图形学算法‼️/tiny-engine/third_party/glm/include/glm/ext/matrix_float2x4_precision.hpp", "C++", 8, 0, 0, 0, 17, 7, 32
"/Users/goujiayuan/STUDY/图形学算法‼️/tiny-engine/third_party/glm/include/glm/ext/matrix_float3x2.hpp", "C++", 6, 0, 0, 0, 8, 5, 19
"/Users/goujiayuan/STUDY/图形学算法‼️/tiny-engine/third_party/glm/include/glm/ext/matrix_float3x2_precision.hpp", "C++", 8, 0, 0, 0, 17, 7, 32
"/Users/goujiayuan/STUDY/图形学算法‼️/tiny-engine/third_party/glm/include/glm/ext/matrix_float3x3.hpp", "C++", 7, 0, 0, 0, 11, 6, 24
"/Users/goujiayuan/STUDY/图形学算法‼️/tiny-engine/third_party/glm/include/glm/ext/matrix_float3x3_precision.hpp", "C++", 11, 0, 0, 0, 29, 10, 50
"/Users/goujiayuan/STUDY/图形学算法‼️/tiny-engine/third_party/glm/include/glm/ext/matrix_float3x4.hpp", "C++", 6, 0, 0, 0, 8, 5, 19
"/Users/goujiayuan/STUDY/图形学算法‼️/tiny-engine/third_party/glm/include/glm/ext/matrix_float3x4_precision.hpp", "C++", 8, 0, 0, 0, 17, 7, 32
"/Users/goujiayuan/STUDY/图形学算法‼️/tiny-engine/third_party/glm/include/glm/ext/matrix_float4x2.hpp", "C++", 6, 0, 0, 0, 8, 5, 19
"/Users/goujiayuan/STUDY/图形学算法‼️/tiny-engine/third_party/glm/include/glm/ext/matrix_float4x2_precision.hpp", "C++", 8, 0, 0, 0, 17, 7, 32
"/Users/goujiayuan/STUDY/图形学算法‼️/tiny-engine/third_party/glm/include/glm/ext/matrix_float4x3.hpp", "C++", 6, 0, 0, 0, 8, 5, 19
"/Users/goujiayuan/STUDY/图形学算法‼️/tiny-engine/third_party/glm/include/glm/ext/matrix_float4x3_precision.hpp", "C++", 8, 0, 0, 0, 17, 7, 32
"/Users/goujiayuan/STUDY/图形学算法‼️/tiny-engine/third_party/glm/include/glm/ext/matrix_float4x4.hpp", "C++", 7, 0, 0, 0, 11, 6, 24
"/Users/goujiayuan/STUDY/图形学算法‼️/tiny-engine/third_party/glm/include/glm/ext/matrix_float4x4_precision.hpp", "C++", 11, 0, 0, 0, 29, 10, 50
"/Users/goujiayuan/STUDY/图形学算法‼️/tiny-engine/third_party/glm/include/glm/ext/matrix_int2x2.hpp", "C++", 10, 0, 0, 0, 21, 8, 39
"/Users/goujiayuan/STUDY/图形学算法‼️/tiny-engine/third_party/glm/include/glm/ext/matrix_int2x2_sized.hpp", "C++", 17, 0, 0, 0, 39, 15, 71
"/Users/goujiayuan/STUDY/图形学算法‼️/tiny-engine/third_party/glm/include/glm/ext/matrix_int2x3.hpp", "C++", 9, 0, 0, 0, 18, 7, 34
"/Users/goujiayuan/STUDY/图形学算法‼️/tiny-engine/third_party/glm/include/glm/ext/matrix_int2x3_sized.hpp", "C++", 13, 0, 0, 0, 27, 10, 50
"/Users/goujiayuan/STUDY/图形学算法‼️/tiny-engine/third_party/glm/include/glm/ext/matrix_int2x4.hpp", "C++", 9, 0, 0, 0, 18, 7, 34
"/Users/goujiayuan/STUDY/图形学算法‼️/tiny-engine/third_party/glm/include/glm/ext/matrix_int2x4_sized.hpp", "C++", 13, 0, 0, 0, 27, 10, 50
"/Users/goujiayuan/STUDY/图形学算法‼️/tiny-engine/third_party/glm/include/glm/ext/matrix_int3x2.hpp", "C++", 9, 0, 0, 0, 18, 7, 34
"/Users/goujiayuan/STUDY/图形学算法‼️/tiny-engine/third_party/glm/include/glm/ext/matrix_int3x2_sized.hpp", "C++", 13, 0, 0, 0, 27, 10, 50
"/Users/goujiayuan/STUDY/图形学算法‼️/tiny-engine/third_party/glm/include/glm/ext/matrix_int3x3.hpp", "C++", 10, 0, 0, 0, 21, 8, 39
"/Users/goujiayuan/STUDY/图形学算法‼️/tiny-engine/third_party/glm/include/glm/ext/matrix_int3x3_sized.hpp", "C++", 17, 0, 0, 0, 39, 15, 71
"/Users/goujiayuan/STUDY/图形学算法‼️/tiny-engine/third_party/glm/include/glm/ext/matrix_int3x4.hpp", "C++", 9, 0, 0, 0, 18, 7, 34
"/Users/goujiayuan/STUDY/图形学算法‼️/tiny-engine/third_party/glm/include/glm/ext/matrix_int3x4_sized.hpp", "C++", 13, 0, 0, 0, 27, 10, 50
"/Users/goujiayuan/STUDY/图形学算法‼️/tiny-engine/third_party/glm/include/glm/ext/matrix_int4x2.hpp", "C++", 9, 0, 0, 0, 18, 7, 34
"/Users/goujiayuan/STUDY/图形学算法‼️/tiny-engine/third_party/glm/include/glm/ext/matrix_int4x2_sized.hpp", "C++", 13, 0, 0, 0, 27, 10, 50
"/Users/goujiayuan/STUDY/图形学算法‼️/tiny-engine/third_party/glm/include/glm/ext/matrix_int4x3.hpp", "C++", 9, 0, 0, 0, 18, 7, 34
"/Users/goujiayuan/STUDY/图形学算法‼️/tiny-engine/third_party/glm/include/glm/ext/matrix_int4x3_sized.hpp", "C++", 13, 0, 0, 0, 27, 10, 50
"/Users/goujiayuan/STUDY/图形学算法‼️/tiny-engine/third_party/glm/include/glm/ext/matrix_int4x4.hpp", "C++", 10, 0, 0, 0, 21, 8, 39
"/Users/goujiayuan/STUDY/图形学算法‼️/tiny-engine/third_party/glm/include/glm/ext/matrix_int4x4_sized.hpp", "C++", 17, 0, 0, 0, 39, 15, 71
"/Users/goujiayuan/STUDY/图形学算法‼️/tiny-engine/third_party/glm/include/glm/ext/matrix_projection.hpp", "C++", 33, 0, 0, 0, 103, 14, 150
"/Users/goujiayuan/STUDY/图形学算法‼️/tiny-engine/third_party/glm/include/glm/ext/matrix_projection.inl", "C++", 85, 0, 0, 0, 1, 21, 107
"/Users/goujiayuan/STUDY/图形学算法‼️/tiny-engine/third_party/glm/include/glm/ext/matrix_relational.hpp", "C++", 29, 0, 0, 0, 87, 17, 133
"/Users/goujiayuan/STUDY/图形学算法‼️/tiny-engine/third_party/glm/include/glm/ext/matrix_relational.inl", "C++", 67, 0, 0, 0, 3, 13, 83
"/Users/goujiayuan/STUDY/图形学算法‼️/tiny-engine/third_party/glm/include/glm/ext/matrix_transform.hpp", "C++", 32, 0, 0, 0, 99, 14, 145
"/Users/goujiayuan/STUDY/图形学算法‼️/tiny-engine/third_party/glm/include/glm/ext/matrix_transform.inl", "C++", 132, 0, 0, 0, 0, 21, 153
"/Users/goujiayuan/STUDY/图形学算法‼️/tiny-engine/third_party/glm/include/glm/ext/matrix_uint2x2.hpp", "C++", 10, 0, 0, 0, 21, 8, 39
"/Users/goujiayuan/STUDY/图形学算法‼️/tiny-engine/third_party/glm/include/glm/ext/matrix_uint2x2_sized.hpp", "C++", 17, 0, 0, 0, 39, 15, 71
"/Users/goujiayuan/STUDY/图形学算法‼️/tiny-engine/third_party/glm/include/glm/ext/matrix_uint2x3.hpp", "C++", 9, 0, 0, 0, 18, 7, 34
"/Users/goujiayuan/STUDY/图形学算法‼️/tiny-engine/third_party/glm/include/glm/ext/matrix_uint2x3_sized.hpp", "C++", 13, 0, 0, 0, 27, 10, 50
"/Users/goujiayuan/STUDY/图形学算法‼️/tiny-engine/third_party/glm/include/glm/ext/matrix_uint2x4.hpp", "C++", 9, 0, 0, 0, 18, 7, 34
"/Users/goujiayuan/STUDY/图形学算法‼️/tiny-engine/third_party/glm/include/glm/ext/matrix_uint2x4_sized.hpp", "C++", 13, 0, 0, 0, 27, 10, 50
"/Users/goujiayuan/STUDY/图形学算法‼️/tiny-engine/third_party/glm/include/glm/ext/matrix_uint3x2.hpp", "C++", 9, 0, 0, 0, 18, 7, 34
"/Users/goujiayuan/STUDY/图形学算法‼️/tiny-engine/third_party/glm/include/glm/ext/matrix_uint3x2_sized.hpp", "C++", 13, 0, 0, 0, 27, 10, 50
"/Users/goujiayuan/STUDY/图形学算法‼️/tiny-engine/third_party/glm/include/glm/ext/matrix_uint3x3.hpp", "C++", 10, 0, 0, 0, 21, 8, 39
"/Users/goujiayuan/STUDY/图形学算法‼️/tiny-engine/third_party/glm/include/glm/ext/matrix_uint3x3_sized.hpp", "C++", 17, 0, 0, 0, 39, 15, 71
"/Users/goujiayuan/STUDY/图形学算法‼️/tiny-engine/third_party/glm/include/glm/ext/matrix_uint3x4.hpp", "C++", 9, 0, 0, 0, 18, 7, 34
"/Users/goujiayuan/STUDY/图形学算法‼️/tiny-engine/third_party/glm/include/glm/ext/matrix_uint3x4_sized.hpp", "C++", 13, 0, 0, 0, 27, 10, 50
"/Users/goujiayuan/STUDY/图形学算法‼️/tiny-engine/third_party/glm/include/glm/ext/matrix_uint4x2.hpp", "C++", 9, 0, 0, 0, 18, 7, 34
"/Users/goujiayuan/STUDY/图形学算法‼️/tiny-engine/third_party/glm/include/glm/ext/matrix_uint4x2_sized.hpp", "C++", 13, 0, 0, 0, 27, 10, 50
"/Users/goujiayuan/STUDY/图形学算法‼️/tiny-engine/third_party/glm/include/glm/ext/matrix_uint4x3.hpp", "C++", 9, 0, 0, 0, 18, 7, 34
"/Users/goujiayuan/STUDY/图形学算法‼️/tiny-engine/third_party/glm/include/glm/ext/matrix_uint4x3_sized.hpp", "C++", 13, 0, 0, 0, 27, 10, 50
"/Users/goujiayuan/STUDY/图形学算法‼️/tiny-engine/third_party/glm/include/glm/ext/matrix_uint4x4.hpp", "C++", 10, 0, 0, 0, 21, 8, 39
"/Users/goujiayuan/STUDY/图形学算法‼️/tiny-engine/third_party/glm/include/glm/ext/matrix_uint4x4_sized.hpp", "C++", 17, 0, 0, 0, 39, 15, 71
"/Users/goujiayuan/STUDY/图形学算法‼️/tiny-engine/third_party/glm/include/glm/ext/quaternion_common.hpp", "C++", 30, 0, 0, 0, 91, 15, 136
"/Users/goujiayuan/STUDY/图形学算法‼️/tiny-engine/third_party/glm/include/glm/ext/quaternion_common.inl", "C++", 107, 0, 0, 0, 14, 24, 145
"/Users/goujiayuan/STUDY/图形学算法‼️/tiny-engine/third_party/glm/include/glm/ext/quaternion_common_simd.inl", "C++", 15, 0, 0, 0, 0, 4, 19
"/Users/goujiayuan/STUDY/图形学算法‼️/tiny-engine/third_party/glm/include/glm/ext/quaternion_double.hpp", "C++", 9, 0, 0, 0, 23, 8, 40
"/Users/goujiayuan/STUDY/图形学算法‼️/tiny-engine/third_party/glm/include/glm/ext/quaternion_double_precision.hpp", "C++", 11, 0, 0, 0, 22, 10, 43
"/Users/goujiayuan/STUDY/图形学算法‼️/tiny-engine/third_party/glm/include/glm/ext/quaternion_exponential.hpp", "C++", 20, 0, 0, 0, 33, 11, 64
"/Users/goujiayuan/STUDY/图形学算法‼️/tiny-engine/third_party/glm/include/glm/ext/quaternion_exponential.inl", "C++", 64, 0, 0, 0, 8, 14, 86
"/Users/goujiayuan/STUDY/图形学算法‼️/tiny-engine/third_party/glm/include/glm/ext/quaternion_float.hpp", "C++", 9, 0, 0, 0, 23, 8, 40
"/Users/goujiayuan/STUDY/图形学算法‼️/tiny-engine/third_party/glm/include/glm/ext/quaternion_float_precision.hpp", "C++", 11, 0, 0, 0, 16, 10, 37
"/Users/goujiayuan/STUDY/图形学算法‼️/tiny-engine/third_party/glm/include/glm/ext/quaternion_geometric.hpp", "C++", 19, 0, 0, 0, 41, 11, 71
"/Users/goujiayuan/STUDY/图形学算法‼️/tiny-engine/third_party/glm/include/glm/ext/quaternion_geometric.inl", "C++", 32, 0, 0, 0, 0, 5, 37
"/Users/goujiayuan/STUDY/图形学算法‼️/tiny-engine/third_party/glm/include/glm/ext/quaternion_relational.hpp", "C++", 17, 0, 0, 0, 35, 11, 63
"/Users/goujiayuan/STUDY/图形学算法‼️/tiny-engine/third_party/glm/include/glm/ext/quaternion_relational.inl", "C++", 31, 0, 0, 0, 0, 5, 36
"/Users/goujiayuan/STUDY/图形学算法‼️/tiny-engine/third_party/glm/include/glm/ext/quaternion_transform.hpp", "C++", 13, 0, 0, 0, 28, 7, 48
"/Users/goujiayuan/STUDY/图形学算法‼️/tiny-engine/third_party/glm/include/glm/ext/quaternion_transform.inl", "C++", 19, 0, 0, 0, 1, 5, 25
"/Users/goujiayuan/STUDY/图形学算法‼️/tiny-engine/third_party/glm/include/glm/ext/quaternion_trigonometric.hpp", "C++", 19, 0, 0, 0, 35, 10, 64
"/Users/goujiayuan/STUDY/图形学算法‼️/tiny-engine/third_party/glm/include/glm/ext/quaternion_trigonometric.inl", "C++", 29, 0, 0, 0, 0, 6, 35
"/Users/goujiayuan/STUDY/图形学算法‼️/tiny-engine/third_party/glm/include/glm/ext/scalar_common.hpp", "C++", 39, 0, 0, 0, 97, 22, 158
"/Users/goujiayuan/STUDY/图形学算法‼️/tiny-engine/third_party/glm/include/glm/ext/scalar_common.inl", "C++", 130, 0, 0, 0, 1, 22, 153
"/Users/goujiayuan/STUDY/图形学算法‼️/tiny-engine/third_party/glm/include/glm/ext/scalar_constants.hpp", "C++", 15, 0, 0, 0, 16, 10, 41
"/Users/goujiayuan/STUDY/图形学算法‼️/tiny-engine/third_party/glm/include/glm/ext/scalar_constants.inl", "C++", 21, 0, 0, 0, 0, 4, 25
"/Users/goujiayuan/STUDY/图形学算法‼️/tiny-engine/third_party/glm/include/glm/ext/scalar_int_sized.hpp", "C++", 38, 0, 0, 0, 18, 15, 71
"/Users/goujiayuan/STUDY/图形学算法‼️/tiny-engine/third_party/glm/include/glm/ext/scalar_integer.hpp", "C++", 29, 0, 0, 0, 50, 14, 93
"/Users/goujiayuan/STUDY/图形学算法‼️/tiny-engine/third_party/glm/include/glm/ext/scalar_integer.inl", "C++", 208, 0, 0, 0, 0, 36, 244
"/Users/goujiayuan/STUDY/图形学算法‼️/tiny-engine/third_party/glm/include/glm/ext/scalar_packing.hpp", "C++", 9, 0, 0, 0, 16, 8, 33
"/Users/goujiayuan/STUDY/图形学算法‼️/tiny-engine/third_party/glm/include/glm/ext/scalar_packing.inl", "C++", 0, 0, 0, 0, 0, 1, 1
"/Users/goujiayuan/STUDY/图形学算法‼️/tiny-engine/third_party/glm/include/glm/ext/scalar_relational.hpp", "C++", 17, 0, 0, 0, 39, 10, 66
"/Users/goujiayuan/STUDY/图形学算法‼️/tiny-engine/third_party/glm/include/glm/ext/scalar_relational.inl", "C++", 32, 0, 0, 0, 2, 7, 41
"/Users/goujiayuan/STUDY/图形学算法‼️/tiny-engine/third_party/glm/include/glm/ext/scalar_uint_sized.hpp", "C++", 38, 0, 0, 0, 18, 15, 71
"/Users/goujiayuan/STUDY/图形学算法‼️/tiny-engine/third_party/glm/include/glm/ext/scalar_ulp.hpp", "C++", 21, 0, 0, 0, 42, 12, 75
"/Users/goujiayuan/STUDY/图形学算法‼️/tiny-engine/third_party/glm/include/glm/ext/scalar_ulp.inl", "C++", 250, 0, 0, 0, 7, 28, 285
"/Users/goujiayuan/STUDY/图形学算法‼️/tiny-engine/third_party/glm/include/glm/ext/vector_bool1.hpp", "C++", 9, 0, 0, 0, 15, 7, 31
"/Users/goujiayuan/STUDY/图形学算法‼️/tiny-engine/third_party/glm/include/glm/ext/vector_bool1_precision.hpp", "C++", 11, 0, 0, 0, 15, 9, 35
"/Users/goujiayuan/STUDY/图形学算法‼️/tiny-engine/third_party/glm/include/glm/ext/vector_bool2.hpp", "C++", 6, 0, 0, 0, 8, 5, 19
"/Users/goujiayuan/STUDY/图形学算法‼️/tiny-engine/third_party/glm/include/glm/ext/vector_bool2_precision.hpp", "C++", 8, 0, 0, 0, 17, 7, 32
"/Users/goujiayuan/STUDY/图形学算法‼️/tiny-engine/third_party/glm/include/glm/ext/vector_bool3.hpp", "C++", 6, 0, 0, 0, 8, 5, 19
"/Users/goujiayuan/STUDY/图形学算法‼️/tiny-engine/third_party/glm/include/glm/ext/vector_bool3_precision.hpp", "C++", 8, 0, 0, 0, 17, 7, 32
"/Users/goujiayuan/STUDY/图形学算法‼️/tiny-engine/third_party/glm/include/glm/ext/vector_bool4.hpp", "C++", 6, 0, 0, 0, 8, 5, 19
"/Users/goujiayuan/STUDY/图形学算法‼️/tiny-engine/third_party/glm/include/glm/ext/vector_bool4_precision.hpp", "C++", 8, 0, 0, 0, 17, 7, 32
"/Users/goujiayuan/STUDY/图形学算法‼️/tiny-engine/third_party/glm/include/glm/ext/vector_common.hpp", "C++", 46, 0, 0, 0, 134, 25, 205
"/Users/goujiayuan/STUDY/图形学算法‼️/tiny-engine/third_party/glm/include/glm/ext/vector_common.inl", "C++", 111, 0, 0, 0, 0, 19, 130
"/Users/goujiayuan/STUDY/图形学算法‼️/tiny-engine/third_party/glm/include/glm/ext/vector_double1.hpp", "C++", 9, 0, 0, 0, 16, 7, 32
"/Users/goujiayuan/STUDY/图形学算法‼️/tiny-engine/third_party/glm/include/glm/ext/vector_double1_precision.hpp", "C++", 11, 0, 0, 0, 17, 9, 37
"/Users/goujiayuan/STUDY/图形学算法‼️/tiny-engine/third_party/glm/include/glm/ext/vector_double2.hpp", "C++", 6, 0, 0, 0, 8, 5, 19
"/Users/goujiayuan/STUDY/图形学算法‼️/tiny-engine/third_party/glm/include/glm/ext/vector_double2_precision.hpp", "C++", 8, 0, 0, 0, 17, 7, 32
"/Users/goujiayuan/STUDY/图形学算法‼️/tiny-engine/third_party/glm/include/glm/ext/vector_double3.hpp", "C++", 6, 0, 0, 0, 8, 5, 19
"/Users/goujiayuan/STUDY/图形学算法‼️/tiny-engine/third_party/glm/include/glm/ext/vector_double3_precision.hpp", "C++", 8, 0, 0, 0, 20, 7, 35
"/Users/goujiayuan/STUDY/图形学算法‼️/tiny-engine/third_party/glm/include/glm/ext/vector_double4.hpp", "C++", 6, 0, 0, 0, 8, 5, 19
"/Users/goujiayuan/STUDY/图形学算法‼️/tiny-engine/third_party/glm/include/glm/ext/vector_double4_precision.hpp", "C++", 9, 0, 0, 0, 20, 7, 36
"/Users/goujiayuan/STUDY/图形学算法‼️/tiny-engine/third_party/glm/include/glm/ext/vector_float1.hpp", "C++", 9, 0, 0, 0, 16, 7, 32
"/Users/goujiayuan/STUDY/图形学算法‼️/tiny-engine/third_party/glm/include/glm/ext/vector_float1_precision.hpp", "C++", 11, 0, 0, 0, 17, 9, 37
"/Users/goujiayuan/STUDY/图形学算法‼️/tiny-engine/third_party/glm/include/glm/ext/vector_float2.hpp", "C++", 6, 0, 0, 0, 8, 5, 19
"/Users/goujiayuan/STUDY/图形学算法‼️/tiny-engine/third_party/glm/include/glm/ext/vector_float2_precision.hpp", "C++", 8, 0, 0, 0, 17, 7, 32
"/Users/goujiayuan/STUDY/图形学算法‼️/tiny-engine/third_party/glm/include/glm/ext/vector_float3.hpp", "C++", 6, 0, 0, 0, 8, 5, 19
"/Users/goujiayuan/STUDY/图形学算法‼️/tiny-engine/third_party/glm/include/glm/ext/vector_float3_precision.hpp", "C++", 8, 0, 0, 0, 17, 7, 32
"/Users/goujiayuan/STUDY/图形学算法‼️/tiny-engine/third_party/glm/include/glm/ext/vector_float4.hpp", "C++", 6, 0, 0, 0, 8, 5, 19
"/Users/goujiayuan/STUDY/图形学算法‼️/tiny-engine/third_party/glm/include/glm/ext/vector_float4_precision.hpp", "C++", 8, 0, 0, 0, 17, 7, 32
"/Users/goujiayuan/STUDY/图形学算法‼️/tiny-engine/third_party/glm/include/glm/ext/vector_int1.hpp", "C++", 9, 0, 0, 0, 16, 8, 33
"/Users/goujiayuan/STUDY/图形学算法‼️/tiny-engine/third_party/glm/include/glm/ext/vector_int1_sized.hpp", "C++", 13, 0, 0, 0, 27, 10, 50
"/Users/goujiayuan/STUDY/图形学算法‼️/tiny-engine/third_party/glm/include/glm/ext/vector_int2.hpp", "C++", 6, 0, 0, 0, 8, 5, 19
"/Users/goujiayuan/STUDY/图形学算法‼️/tiny-engine/third_party/glm/include/glm/ext/vector_int2_sized.hpp", "C++", 13, 0, 0, 0, 27, 10, 50
"/Users/goujiayuan/STUDY/图形学算法‼️/tiny-engine/third_party/glm/include/glm/ext/vector_int3.hpp", "C++", 6, 0, 0, 0, 8, 5, 19
"/Users/goujiayuan/STUDY/图形学算法‼️/tiny-engine/third_party/glm/include/glm/ext/vector_int3_sized.hpp", "C++", 13, 0, 0, 0, 27, 10, 50
"/Users/goujiayuan/STUDY/图形学算法‼️/tiny-engine/third_party/glm/include/glm/ext/vector_int4.hpp", "C++", 6, 0, 0, 0, 8, 5, 19
"/Users/goujiayuan/STUDY/图形学算法‼️/tiny-engine/third_party/glm/include/glm/ext/vector_int4_sized.hpp", "C++", 13, 0, 0, 0, 27, 10, 50
"/Users/goujiayuan/STUDY/图形学算法‼️/tiny-engine/third_party/glm/include/glm/ext/vector_integer.hpp", "C++", 34, 0, 0, 0, 99, 17, 150
"/Users/goujiayuan/STUDY/图形学算法‼️/tiny-engine/third_party/glm/include/glm/ext/vector_integer.inl", "C++", 65, 0, 0, 0, 0, 21, 86
"/Users/goujiayuan/STUDY/图形学算法‼️/tiny-engine/third_party/glm/include/glm/ext/vector_packing.hpp", "C++", 9, 0, 0, 0, 16, 8, 33
"/Users/goujiayuan/STUDY/图形学算法‼️/tiny-engine/third_party/glm/include/glm/ext/vector_packing.inl", "C++", 0, 0, 0, 0, 0, 1, 1
"/Users/goujiayuan/STUDY/图形学算法‼️/tiny-engine/third_party/glm/include/glm/ext/vector_relational.hpp", "C++", 25, 0, 0, 0, 68, 15, 108
"/Users/goujiayuan/STUDY/图形学算法‼️/tiny-engine/third_party/glm/include/glm/ext/vector_relational.inl", "C++", 62, 0, 0, 0, 3, 11, 76
"/Users/goujiayuan/STUDY/图形学算法‼️/tiny-engine/third_party/glm/include/glm/ext/vector_uint1.hpp", "C++", 9, 0, 0, 0, 16, 8, 33
"/Users/goujiayuan/STUDY/图形学算法‼️/tiny-engine/third_party/glm/include/glm/ext/vector_uint1_sized.hpp", "C++", 13, 0, 0, 0, 27, 10, 50
"/Users/goujiayuan/STUDY/图形学算法‼️/tiny-engine/third_party/glm/include/glm/ext/vector_uint2.hpp", "C++", 6, 0, 0, 0, 8, 5, 19
"/Users/goujiayuan/STUDY/图形学算法‼️/tiny-engine/third_party/glm/include/glm/ext/vector_uint2_sized.hpp", "C++", 13, 0, 0, 0, 27, 10, 50
"/Users/goujiayuan/STUDY/图形学算法‼️/tiny-engine/third_party/glm/include/glm/ext/vector_uint3.hpp", "C++", 6, 0, 0, 0, 8, 5, 19
"/Users/goujiayuan/STUDY/图形学算法‼️/tiny-engine/third_party/glm/include/glm/ext/vector_uint3_sized.hpp", "C++", 13, 0, 0, 0, 27, 10, 50
"/Users/goujiayuan/STUDY/图形学算法‼️/tiny-engine/third_party/glm/include/glm/ext/vector_uint4.hpp", "C++", 6, 0, 0, 0, 8, 5, 19
"/Users/goujiayuan/STUDY/图形学算法‼️/tiny-engine/third_party/glm/include/glm/ext/vector_uint4_sized.hpp", "C++", 13, 0, 0, 0, 27, 10, 50
"/Users/goujiayuan/STUDY/图形学算法‼️/tiny-engine/third_party/glm/include/glm/ext/vector_ulp.hpp", "C++", 25, 0, 0, 0, 71, 14, 110
"/Users/goujiayuan/STUDY/图形学算法‼️/tiny-engine/third_party/glm/include/glm/ext/vector_ulp.inl", "C++", 67, 0, 0, 0, 0, 8, 75
"/Users/goujiayuan/STUDY/图形学算法‼️/tiny-engine/third_party/glm/include/glm/fwd.hpp", "C++", 1013, 0, 0, 0, 12, 209, 1234
"/Users/goujiayuan/STUDY/图形学算法‼️/tiny-engine/third_party/glm/include/glm/geometric.hpp", "C++", 30, 0, 0, 0, 73, 14, 117
"/Users/goujiayuan/STUDY/图形学算法‼️/tiny-engine/third_party/glm/include/glm/glm.hpp", "C++", 29, 0, 0, 0, 101, 7, 137
"/Users/goujiayuan/STUDY/图形学算法‼️/tiny-engine/third_party/glm/include/glm/gtc/bitfield.hpp", "C++", 57, 0, 0, 0, 170, 40, 267
"/Users/goujiayuan/STUDY/图形学算法‼️/tiny-engine/third_party/glm/include/glm/gtc/bitfield.inl", "C++", 486, 0, 0, 0, 1, 140, 627
"/Users/goujiayuan/STUDY/图形学算法‼️/tiny-engine/third_party/glm/include/glm/gtc/color_space.hpp", "C++", 22, 0, 0, 0, 24, 11, 57
"/Users/goujiayuan/STUDY/图形学算法‼️/tiny-engine/third_party/glm/include/glm/gtc/color_space.inl", "C++", 72, 0, 0, 0, 2, 11, 85
"/Users/goujiayuan/STUDY/图形学算法‼️/tiny-engine/third_party/glm/include/glm/gtc/constants.hpp", "C++", 63, 0, 0, 0, 69, 34, 166
"/Users/goujiayuan/STUDY/图形学算法‼️/tiny-engine/third_party/glm/include/glm/gtc/constants.inl", "C++", 138, 0, 0, 0, 1, 29, 168
"/Users/goujiayuan/STUDY/图形学算法‼️/tiny-engine/third_party/glm/include/glm/gtc/epsilon.hpp", "C++", 18, 0, 0, 0, 32, 11, 61
"/Users/goujiayuan/STUDY/图形学算法‼️/tiny-engine/third_party/glm/include/glm/gtc/epsilon.inl", "C++", 67, 0, 0, 0, 2, 12, 81
"/Users/goujiayuan/STUDY/图形学算法‼️/tiny-engine/third_party/glm/include/glm/gtc/integer.hpp", "C++", 20, 0, 0, 0, 36, 10, 66
"/Users/goujiayuan/STUDY/图形学算法‼️/tiny-engine/third_party/glm/include/glm/gtc/integer.inl", "C++", 56, 0, 0, 0, 3, 10, 69
"/Users/goujiayuan/STUDY/图形学算法‼️/tiny-engine/third_party/glm/include/glm/gtc/matrix_access.hpp", "C++", 27, 0, 0, 0, 23, 11, 61
"/Users/goujiayuan/STUDY/图形学算法‼️/tiny-engine/third_party/glm/include/glm/gtc/matrix_access.inl", "C++", 53, 0, 0, 0, 1, 9, 63
"/Users/goujiayuan/STUDY/图形学算法‼️/tiny-engine/third_party/glm/include/glm/gtc/matrix_integer.hpp", "C++", 112, 0, 0, 0, 207, 115, 434
"/Users/goujiayuan/STUDY/图形学算法‼️/tiny-engine/third_party/glm/include/glm/gtc/matrix_inverse.hpp", "C++", 17, 0, 0, 0, 25, 9, 51
"/Users/goujiayuan/STUDY/图形学算法‼️/tiny-engine/third_party/glm/include/glm/gtc/matrix_inverse.inl", "C++", 99, 0, 0, 0, 1, 19, 119
"/Users/goujiayuan/STUDY/图形学算法‼️/tiny-engine/third_party/glm/include/glm/gtc/matrix_transform.hpp", "C++", 12, 0, 0, 0, 20, 5, 37
"/Users/goujiayuan/STUDY/图形学算法‼️/tiny-engine/third_party/glm/include/glm/gtc/matrix_transform.inl", "C++", 3, 0, 0, 0, 0, 1, 4
"/Users/goujiayuan/STUDY/图形学算法‼️/tiny-engine/third_party/glm/include/glm/gtc/noise.hpp", "C++", 27, 0, 0, 0, 25, 10, 62
"/Users/goujiayuan/STUDY/图形学算法‼️/tiny-engine/third_party/glm/include/glm/gtc/noise.inl", "C++", 582, 0, 0, 0, 133, 93, 808
"/Users/goujiayuan/STUDY/图形学算法‼️/tiny-engine/third_party/glm/include/glm/gtc/packing.hpp", "C++", 88, 0, 0, 0, 561, 80, 729
"/Users/goujiayuan/STUDY/图形学算法‼️/tiny-engine/third_party/glm/include/glm/gtc/packing.inl", "C++", 752, 0, 0, 0, 61, 126, 939
"/Users/goujiayuan/STUDY/图形学算法‼️/tiny-engine/third_party/glm/include/glm/gtc/quaternion.hpp", "C++", 60, 0, 0, 0, 93, 21, 174
"/Users/goujiayuan/STUDY/图形学算法‼️/tiny-engine/third_party/glm/include/glm/gtc/quaternion.inl", "C++", 171, 0, 0, 0, 1, 31, 203
"/Users/goujiayuan/STUDY/图形学算法‼️/tiny-engine/third_party/glm/include/glm/gtc/quaternion_simd.inl", "C++", 0, 0, 0, 0, 0, 1, 1
"/Users/goujiayuan/STUDY/图形学算法‼️/tiny-engine/third_party/glm/include/glm/gtc/random.hpp", "C++", 25, 0, 0, 0, 44, 14, 83
"/Users/goujiayuan/STUDY/图形学算法‼️/tiny-engine/third_party/glm/include/glm/gtc/random.inl", "C++", 262, 0, 0, 0, 0, 42, 304
"/Users/goujiayuan/STUDY/图形学算法‼️/tiny-engine/third_party/glm/include/glm/gtc/reciprocal.hpp", "C++", 33, 0, 0, 0, 84, 19, 136
"/Users/goujiayuan/STUDY/图形学算法‼️/tiny-engine/third_party/glm/include/glm/gtc/reciprocal.inl", "C++", 151, 0, 0, 0, 13, 28, 192
"/Users/goujiayuan/STUDY/图形学算法‼️/tiny-engine/third_party/glm/include/glm/gtc/round.hpp", "C++", 38, 0, 0, 0, 104, 19, 161
"/Users/goujiayuan/STUDY/图形学算法‼️/tiny-engine/third_party/glm/include/glm/gtc/round.inl", "C++", 118, 0, 0, 0, 13, 25, 156
"/Users/goujiayuan/STUDY/图形学算法‼️/tiny-engine/third_party/glm/include/glm/gtc/type_aligned.hpp", "C++", 547, 0, 0, 0, 384, 385, 1316
"/Users/goujiayuan/STUDY/图形学算法‼️/tiny-engine/third_party/glm/include/glm/gtc/type_precision.hpp", "C++", 514, 0, 0, 0, 1018, 563, 2095
"/Users/goujiayuan/STUDY/图形学算法‼️/tiny-engine/third_party/glm/include/glm/gtc/type_precision.inl", "C++", 3, 0, 0, 0, 1, 3, 7
"/Users/goujiayuan/STUDY/图形学算法‼️/tiny-engine/third_party/glm/include/glm/gtc/type_ptr.hpp", "C++", 89, 0, 0, 0, 102, 40, 231
"/Users/goujiayuan/STUDY/图形学算法‼️/tiny-engine/third_party/glm/include/glm/gtc/type_ptr.inl", "C++", 320, 0, 0, 0, 4, 63, 387
"/Users/goujiayuan/STUDY/图形学算法‼️/tiny-engine/third_party/glm/include/glm/gtc/ulp.hpp", "C++", 38, 0, 0, 0, 95, 20, 153
"/Users/goujiayuan/STUDY/图形学算法‼️/tiny-engine/third_party/glm/include/glm/gtc/ulp.inl", "C++", 150, 0, 0, 0, 1, 23, 174
"/Users/goujiayuan/STUDY/图形学算法‼️/tiny-engine/third_party/glm/include/glm/gtc/vec1.hpp", "C++", 14, 0, 0, 0, 12, 5, 31
"/Users/goujiayuan/STUDY/图形学算法‼️/tiny-engine/third_party/glm/include/glm/gtx/associated_min_max.hpp", "C++", 119, 0, 0, 0, 60, 29, 208
"/Users/goujiayuan/STUDY/图形学算法‼️/tiny-engine/third_party/glm/include/glm/gtx/associated_min_max.inl", "C++", 310, 0, 0, 0, 19, 26, 355
"/Users/goujiayuan/STUDY/图形学算法‼️/tiny-engine/third_party/glm/include/glm/gtx/bit.hpp", "C++", 31, 0, 0, 0, 50, 18, 99
"/Users/goujiayuan/STUDY/图形学算法‼️/tiny-engine/third_party/glm/include/glm/gtx/bit.inl", "C++", 64, 0, 0, 0, 11, 18, 93
"/Users/goujiayuan/STUDY/图形学算法‼️/tiny-engine/third_party/glm/include/glm/gtx/closest_point.hpp", "C++", 23, 0, 0, 0, 18, 9, 50
"/Users/goujiayuan/STUDY/图形学算法‼️/tiny-engine/third_party/glm/include/glm/gtx/closest_point.inl", "C++", 35, 0, 0, 0, 3, 8, 46
"/Users/goujiayuan/STUDY/图形学算法‼️/tiny-engine/third_party/glm/include/glm/gtx/color_encoding.hpp", "C++", 24, 0, 0, 0, 20, 11, 55
"/Users/goujiayuan/STUDY/图形学算法‼️/tiny-engine/third_party/glm/include/glm/gtx/color_encoding.inl", "C++", 35, 0, 0, 0, 1, 10, 46
"/Users/goujiayuan/STUDY/图形学算法‼️/tiny-engine/third_party/glm/include/glm/gtx/color_space.hpp", "C++", 33, 0, 0, 0, 27, 13, 73
"/Users/goujiayuan/STUDY/图形学算法‼️/tiny-engine/third_party/glm/include/glm/gtx/color_space.inl", "C++", 117, 0, 0, 0, 7, 18, 142
"/Users/goujiayuan/STUDY/图形学算法‼️/tiny-engine/third_party/glm/include/glm/gtx/color_space_YCoCg.hpp", "C++", 25, 0, 0, 0, 25, 11, 61
"/Users/goujiayuan/STUDY/图形学算法‼️/tiny-engine/third_party/glm/include/glm/gtx/color_space_YCoCg.inl", "C++", 98, 0, 0, 0, 1, 9, 108
"/Users/goujiayuan/STUDY/图形学算法‼️/tiny-engine/third_party/glm/include/glm/gtx/common.hpp", "C++", 24, 0, 0, 0, 42, 11, 77
"/Users/goujiayuan/STUDY/图形学算法‼️/tiny-engine/third_party/glm/include/glm/gtx/common.inl", "C++", 105, 0, 0, 0, 2, 19, 126
"/Users/goujiayuan/STUDY/图形学算法‼️/tiny-engine/third_party/glm/include/glm/gtx/compatibility.hpp", "C++", 98, 0, 0, 0, 15, 21, 134
"/Users/goujiayuan/STUDY/图形学算法‼️/tiny-engine/third_party/glm/include/glm/gtx/compatibility.inl", "C++", 55, 0, 0, 0, 1, 7, 63
"/Users/goujiayuan/STUDY/图形学算法‼️/tiny-engine/third_party/glm/include/glm/gtx/component_wise.hpp", "C++", 26, 0, 0, 0, 31, 13, 70
"/Users/goujiayuan/STUDY/图形学算法‼️/tiny-engine/third_party/glm/include/glm/gtx/component_wise.inl", "C++", 109, 0, 0, 0, 1, 18, 128
"/Users/goujiayuan/STUDY/图形学算法‼️/tiny-engine/third_party/glm/include/glm/gtx/dual_quaternion.hpp", "C++", 121, 0, 0, 0, 89, 65, 275
"/Users/goujiayuan/STUDY/图形学算法‼️/tiny-engine/third_party/glm/include/glm/gtx/dual_quaternion.inl", "C++", 286, 0, 0, 0, 12, 55, 353
"/Users/goujiayuan/STUDY/图形学算法‼️/tiny-engine/third_party/glm/include/glm/gtx/easing.hpp", "C++", 82, 0, 0, 0, 97, 41, 220
"/Users/goujiayuan/STUDY/图形学算法‼️/tiny-engine/third_party/glm/include/glm/gtx/easing.inl", "C++", 334, 0, 0, 0, 32, 71, 437
"/Users/goujiayuan/STUDY/图形学算法‼️/tiny-engine/third_party/glm/include/glm/gtx/euler_angles.hpp", "C++", 188, 0, 0, 0, 100, 48, 336
"/Users/goujiayuan/STUDY/图形学算法‼️/tiny-engine/third_party/glm/include/glm/gtx/euler_angles.inl", "C++", 833, 0, 0, 0, 1, 66, 900
"/Users/goujiayuan/STUDY/图形学算法‼️/tiny-engine/third_party/glm/include/glm/gtx/extend.hpp", "C++", 18, 0, 0, 0, 17, 8, 43
"/Users/goujiayuan/STUDY/图形学算法‼️/tiny-engine/third_party/glm/include/glm/gtx/extend.inl", "C++", 43, 0, 0, 0, 1, 5, 49
"/Users/goujiayuan/STUDY/图形学算法‼️/tiny-engine/third_party/glm/include/glm/gtx/extended_min_max.hpp", "C++", 80, 0, 0, 0, 39, 19, 138
"/Users/goujiayuan/STUDY/图形学算法‼️/tiny-engine/third_party/glm/include/glm/gtx/extended_min_max.inl", "C++", 125, 0, 0, 0, 1, 13, 139
"/Users/goujiayuan/STUDY/图形学算法‼️/tiny-engine/third_party/glm/include/glm/gtx/exterior_product.hpp", "C++", 16, 0, 0, 0, 22, 8, 46
"/Users/goujiayuan/STUDY/图形学算法‼️/tiny-engine/third_party/glm/include/glm/gtx/exterior_product.inl", "C++", 20, 0, 0, 0, 1, 6, 27
"/Users/goujiayuan/STUDY/图形学算法‼️/tiny-engine/third_party/glm/include/glm/gtx/fast_exponential.hpp", "C++", 37, 0, 0, 0, 40, 19, 96
"/Users/goujiayuan/STUDY/图形学算法‼️/tiny-engine/third_party/glm/include/glm/gtx/fast_exponential.inl", "C++", 73, 0, 0, 0, 50, 14, 137
"/Users/goujiayuan/STUDY/图形学算法‼️/tiny-engine/third_party/glm/include/glm/gtx/fast_square_root.hpp", "C++", 33, 0, 0, 0, 44, 16, 93
"/Users/goujiayuan/STUDY/图形学算法‼️/tiny-engine/third_party/glm/include/glm/gtx/fast_square_root.inl", "C++", 56, 0, 0, 0, 6, 14, 76
"/Users/goujiayuan/STUDY/图形学算法‼️/tiny-engine/third_party/glm/include/glm/gtx/fast_trigonometry.hpp", "C++", 29, 0, 0, 0, 36, 15, 80
"/Users/goujiayuan/STUDY/图形学算法‼️/tiny-engine/third_party/glm/include/glm/gtx/fast_trigonometry.inl", "C++", 113, 0, 0, 0, 8, 22, 143
"/Users/goujiayuan/STUDY/图形学算法‼️/tiny-engine/third_party/glm/include/glm/gtx/float_notmalize.inl", "C++", 9, 0, 0, 0, 1, 4, 14
"/Users/goujiayuan/STUDY/图形学算法‼️/tiny-engine/third_party/glm/include/glm/gtx/functions.hpp", "C++", 25, 0, 0, 0, 22, 10, 57
"/Users/goujiayuan/STUDY/图形学算法‼️/tiny-engine/third_party/glm/include/glm/gtx/functions.inl", "C++", 25, 0, 0, 0, 1, 5, 31
"/Users/goujiayuan/STUDY/图形学算法‼️/tiny-engine/third_party/glm/include/glm/gtx/gradient_paint.hpp", "C++", 25, 0, 0, 0, 20, 9, 54
"/Users/goujiayuan/STUDY/图形学算法‼️/tiny-engine/third_party/glm/include/glm/gtx/gradient_paint.inl", "C++", 32, 0, 0, 0, 1, 4, 37
"/Users/goujiayuan/STUDY/图形学算法‼️/tiny-engine/third_party/glm/include/glm/gtx/handed_coordinate_space.hpp", "C++", 23, 0, 0, 0, 19, 9, 51
"/Users/goujiayuan/STUDY/图形学算法‼️/tiny-engine/third_party/glm/include/glm/gtx/handed_coordinate_space.inl", "C++", 23, 0, 0, 0, 1, 3, 27
"/Users/goujiayuan/STUDY/图形学算法‼️/tiny-engine/third_party/glm/include/glm/gtx/hash.hpp", "C++", 106, 0, 0, 0, 11, 26, 143
"/Users/goujiayuan/STUDY/图形学算法‼️/tiny-engine/third_party/glm/include/glm/gtx/hash.inl", "C++", 158, 0, 0, 0, 10, 17, 185
"/Users/goujiayuan/STUDY/图形学算法‼️/tiny-engine/third_party/glm/include/glm/gtx/integer.hpp", "C++", 25, 0, 0, 0, 35, 17, 77
"/Users/goujiayuan/STUDY/图形学算法‼️/tiny-engine/third_party/glm/include/glm/gtx/integer.inl", "C++", 131, 0, 0, 0, 25, 30, 186
"/Users/goujiayuan/STUDY/图形学算法‼️/tiny-engine/third_party/glm/include/glm/gtx/intersect.hpp", "C++", 49, 0, 0, 0, 31, 13, 93
"/Users/goujiayuan/STUDY/图形学算法‼️/tiny-engine/third_party/glm/include/glm/gtx/intersect.inl", "C++", 156, 0, 0, 0, 13, 32, 201
"/Users/goujiayuan/STUDY/图形学算法‼️/tiny-engine/third_party/glm/include/glm/gtx/io.hpp", "C++", 138, 0, 0, 0, 23, 41, 202
"/Users/goujiayuan/STUDY/图形学算法‼️/tiny-engine/third_party/glm/include/glm/gtx/io.inl", "C++", 367, 0, 0, 0, 2, 72, 441
"/Users/goujiayuan/STUDY/图形学算法‼️/tiny-engine/third_party/glm/include/glm/gtx/log_base.hpp", "C++", 21, 0, 0, 0, 19, 9, 49
"/Users/goujiayuan/STUDY/图形学算法‼️/tiny-engine/third_party/glm/include/glm/gtx/log_base.inl", "C++", 13, 0, 0, 0, 1, 3, 17
"/Users/goujiayuan/STUDY/图形学算法‼️/tiny-engine/third_party/glm/include/glm/gtx/matrix_cross_product.hpp", "C++", 19, 0, 0, 0, 20, 9, 48
"/Users/goujiayuan/STUDY/图形学算法‼️/tiny-engine/third_party/glm/include/glm/gtx/matrix_cross_product.inl", "C++", 33, 0, 0, 0, 1, 4, 38
"/Users/goujiayuan/STUDY/图形学算法‼️/tiny-engine/third_party/glm/include/glm/gtx/matrix_decompose.hpp", "C++", 22, 0, 0, 0, 17, 8, 47
"/Users/goujiayuan/STUDY/图形学算法‼️/tiny-engine/third_party/glm/include/glm/gtx/matrix_decompose.inl", "C++", 113, 0, 0, 0, 42, 32, 187
"/Users/goujiayuan/STUDY/图形学算法‼️/tiny-engine/third_party/glm/include/glm/gtx/matrix_factorisation.hpp", "C++", 21, 0, 0, 0, 37, 12, 70
"/Users/goujiayuan/STUDY/图形学算法‼️/tiny-engine/third_party/glm/include/glm/gtx/matrix_factorisation.inl", "C++", 53, 0, 0, 0, 17, 15, 85
"/Users/goujiayuan/STUDY/图形学算法‼️/tiny-engine/third_party/glm/include/glm/gtx/matrix_interpolation.hpp", "C++", 25, 0, 0, 0, 25, 11, 61
"/Users/goujiayuan/STUDY/图形学算法‼️/tiny-engine/third_party/glm/include/glm/gtx/matrix_interpolation.inl", "C++", 121, 0, 0, 0, 1, 8, 130
"/Users/goujiayuan/STUDY/图形学算法‼️/tiny-engine/third_party/glm/include/glm/gtx/matrix_major_storage.hpp", "C++", 61, 0, 0, 0, 40, 19, 120
"/Users/goujiayuan/STUDY/图形学算法‼️/tiny-engine/third_party/glm/include/glm/gtx/matrix_major_storage.inl", "C++", 153, 0, 0, 0, 1, 13, 167
"/Users/goujiayuan/STUDY/图形学算法‼️/tiny-engine/third_party/glm/include/glm/gtx/matrix_operation.hpp", "C++", 46, 0, 0, 0, 39, 19, 104
"/Users/goujiayuan/STUDY/图形学算法‼️/tiny-engine/third_party/glm/include/glm/gtx/matrix_operation.inl", "C++", 156, 0, 0, 0, 1, 20, 177
"/Users/goujiayuan/STUDY/图形学算法‼️/tiny-engine/third_party/glm/include/glm/gtx/matrix_query.hpp", "C++", 31, 0, 0, 0, 32, 15, 78
"/Users/goujiayuan/STUDY/图形学算法‼️/tiny-engine/third_party/glm/include/glm/gtx/matrix_query.inl", "C++", 103, 0, 0, 0, 1, 10, 114
"/Users/goujiayuan/STUDY/图形学算法‼️/tiny-engine/third_party/glm/include/glm/gtx/matrix_transform_2d.hpp", "C++", 34, 0, 0, 0, 36, 12, 82
"/Users/goujiayuan/STUDY/图形学算法‼️/tiny-engine/third_party/glm/include/glm/gtx/matrix_transform_2d.inl", "C++", 56, 0, 0, 0, 2, 11, 69
"/Users/goujiayuan/STUDY/图形学算法‼️/tiny-engine/third_party/glm/include/glm/gtx/mixed_product.hpp", "C++", 18, 0, 0, 0, 16, 8, 42
"/Users/goujiayuan/STUDY/图形学算法‼️/tiny-engine/third_party/glm/include/glm/gtx/mixed_product.inl", "C++", 13, 0, 0, 0, 1, 2, 16
"/Users/goujiayuan/STUDY/图形学算法‼️/tiny-engine/third_party/glm/include/glm/gtx/norm.hpp", "C++", 35, 0, 0, 0, 37, 17, 89
"/Users/goujiayuan/STUDY/图形学算法‼️/tiny-engine/third_party/glm/include/glm/gtx/norm.inl", "C++", 79, 0, 0, 0, 1, 16, 96
"/Users/goujiayuan/STUDY/图形学算法‼️/tiny-engine/third_party/glm/include/glm/gtx/normal.hpp", "C++", 15, 0, 0, 0, 19, 8, 42
"/Users/goujiayuan/STUDY/图形学算法‼️/tiny-engine/third_party/glm/include/glm/gtx/normal.inl", "C++", 13, 0, 0, 0, 1, 2, 16
"/Users/goujiayuan/STUDY/图形学算法‼️/tiny-engine/third_party/glm/include/glm/gtx/normalize_dot.hpp", "C++", 17, 0, 0, 0, 24, 9, 50
"/Users/goujiayuan/STUDY/图形学算法‼️/tiny-engine/third_party/glm/include/glm/gtx/normalize_dot.inl", "C++", 13, 0, 0, 0, 1, 3, 17
"/Users/goujiayuan/STUDY/图形学算法‼️/tiny-engine/third_party/glm/include/glm/gtx/number_precision.hpp", "C++", 26, 0, 0, 0, 23, 13, 62
"/Users/goujiayuan/STUDY/图形学算法‼️/tiny-engine/third_party/glm/include/glm/gtx/number_precision.inl", "C++", 3, 0, 0, 0, 1, 3, 7
"/Users/goujiayuan/STUDY/图形学算法‼️/tiny-engine/third_party/glm/include/glm/gtx/optimum_pow.hpp", "C++", 21, 0, 0, 0, 24, 10, 55
"/Users/goujiayuan/STUDY/图形学算法‼️/tiny-engine/third_party/glm/include/glm/gtx/optimum_pow.inl", "C++", 18, 0, 0, 0, 1, 4, 23
"/Users/goujiayuan/STUDY/图形学算法‼️/tiny-engine/third_party/glm/include/glm/gtx/orthonormalize.hpp", "C++", 19, 0, 0, 0, 22, 9, 50
"/Users/goujiayuan/STUDY/图形学算法‼️/tiny-engine/third_party/glm/include/glm/gtx/orthonormalize.inl", "C++", 22, 0, 0, 0, 1, 7, 30
"/Users/goujiayuan/STUDY/图形学算法‼️/tiny-engine/third_party/glm/include/glm/gtx/perpendicular.hpp", "C++", 16, 0, 0, 0, 18, 8, 42
"/Users/goujiayuan/STUDY/图形学算法‼️/tiny-engine/third_party/glm/include/glm/gtx/perpendicular.inl", "C++", 8, 0, 0, 0, 1, 2, 11
"/Users/goujiayuan/STUDY/图形学算法‼️/tiny-engine/third_party/glm/include/glm/gtx/polar_coordinates.hpp", "C++", 19, 0, 0, 0, 21, 9, 49
"/Users/goujiayuan/STUDY/图形学算法‼️/tiny-engine/third_party/glm/include/glm/gtx/polar_coordinates.inl", "C++", 30, 0, 0, 0, 1, 6, 37
"/Users/goujiayuan/STUDY/图形学算法‼️/tiny-engine/third_party/glm/include/glm/gtx/projection.hpp", "C++", 15, 0, 0, 0, 21, 8, 44
"/Users/goujiayuan/STUDY/图形学算法‼️/tiny-engine/third_party/glm/include/glm/gtx/projection.inl", "C++", 8, 0, 0, 0, 1, 2, 11
"/Users/goujiayuan/STUDY/图形学算法‼️/tiny-engine/third_party/glm/include/glm/gtx/quaternion.hpp", "C++", 78, 0, 0, 0, 73, 24, 175
"/Users/goujiayuan/STUDY/图形学算法‼️/tiny-engine/third_party/glm/include/glm/gtx/quaternion.inl", "C++", 128, 0, 0, 0, 9, 23, 160
"/Users/goujiayuan/STUDY/图形学算法‼️/tiny-engine/third_party/glm/include/glm/gtx/range.hpp", "C++", 66, 0, 0, 0, 15, 18, 99
"/Users/goujiayuan/STUDY/图形学算法‼️/tiny-engine/third_party/glm/include/glm/gtx/raw_data.hpp", "C++", 18, 0, 0, 0, 23, 11, 52
"/Users/goujiayuan/STUDY/图形学算法‼️/tiny-engine/third_party/glm/include/glm/gtx/raw_data.inl", "C++", 0, 0, 0, 0, 1, 2, 3
"/Users/goujiayuan/STUDY/图形学算法‼️/tiny-engine/third_party/glm/include/glm/gtx/rotate_normalized_axis.hpp", "C++", 25, 0, 0, 0, 35, 9, 69
"/Users/goujiayuan/STUDY/图形学算法‼️/tiny-engine/third_party/glm/include/glm/gtx/rotate_normalized_axis.inl", "C++", 46, 0, 0, 0, 2, 11, 59
"/Users/goujiayuan/STUDY/图形学算法‼️/tiny-engine/third_party/glm/include/glm/gtx/rotate_vector.hpp", "C++", 63, 0, 0, 0, 43, 18, 124
"/Users/goujiayuan/STUDY/图形学算法‼️/tiny-engine/third_party/glm/include/glm/gtx/rotate_vector.inl", "C++", 149, 0, 0, 0, 18, 21, 188
"/Users/goujiayuan/STUDY/图形学算法‼️/tiny-engine/third_party/glm/include/glm/gtx/scalar_multiplication.hpp", "C++", 53, 0, 0, 0, 13, 10, 76
"/Users/goujiayuan/STUDY/图形学算法‼️/tiny-engine/third_party/glm/include/glm/gtx/scalar_relational.hpp", "C++", 13, 0, 0, 0, 15, 9, 37
"/Users/goujiayuan/STUDY/图形学算法‼️/tiny-engine/third_party/glm/include/glm/gtx/scalar_relational.inl", "C++", 78, 0, 0, 0, 1, 10, 89
"/Users/goujiayuan/STUDY/图形学算法‼️/tiny-engine/third_party/glm/include/glm/gtx/spline.hpp", "C++", 35, 0, 0, 0, 21, 10, 66
"/Users/goujiayuan/STUDY/图形学算法‼️/tiny-engine/third_party/glm/include/glm/gtx/spline.inl", "C++", 51, 0, 0, 0, 1, 9, 61
"/Users/goujiayuan/STUDY/图形学算法‼️/tiny-engine/third_party/glm/include/glm/gtx/std_based_type.hpp", "C++", 22, 0, 0, 0, 32, 15, 69
"/Users/goujiayuan/STUDY/图形学算法‼️/tiny-engine/third_party/glm/include/glm/gtx/std_based_type.inl", "C++", 3, 0, 0, 0, 1, 3, 7
"/Users/goujiayuan/STUDY/图形学算法‼️/tiny-engine/third_party/glm/include/glm/gtx/string_cast.hpp", "C++", 23, 0, 0, 0, 21, 9, 53
"/Users/goujiayuan/STUDY/图形学算法‼️/tiny-engine/third_party/glm/include/glm/gtx/string_cast.inl", "C++", 427, 0, 0, 0, 1, 65, 493
"/Users/goujiayuan/STUDY/图形学算法‼️/tiny-engine/third_party/glm/include/glm/gtx/texture.hpp", "C++", 17, 0, 0, 0, 21, 9, 47
"/Users/goujiayuan/STUDY/图形学算法‼️/tiny-engine/third_party/glm/include/glm/gtx/texture.inl", "C++", 13, 0, 0, 0, 1, 4, 18
"/Users/goujiayuan/STUDY/图形学算法‼️/tiny-engine/third_party/glm/include/glm/gtx/transform.hpp", "C++", 24, 0, 0, 0, 27, 10, 61
"/Users/goujiayuan/STUDY/图形学算法‼️/tiny-engine/third_party/glm/include/glm/gtx/transform.inl", "C++", 18, 0, 0, 0, 1, 5, 24
"/Users/goujiayuan/STUDY/图形学算法‼️/tiny-engine/third_party/glm/include/glm/gtx/transform2.hpp", "C++", 32, 0, 0, 0, 40, 18, 90
"/Users/goujiayuan/STUDY/图形学算法‼️/tiny-engine/third_party/glm/include/glm/gtx/transform2.inl", "C++", 110, 0, 0, 0, 1, 15, 126
"/Users/goujiayuan/STUDY/图形学算法‼️/tiny-engine/third_party/glm/include/glm/gtx/type_aligned.hpp", "C++", 231, 0, 0, 0, 468, 284, 983
"/Users/goujiayuan/STUDY/图形学算法‼️/tiny-engine/third_party/glm/include/glm/gtx/type_aligned.inl", "C++", 3, 0, 0, 0, 1, 3, 7
"/Users/goujiayuan/STUDY/图形学算法‼️/tiny-engine/third_party/glm/include/glm/gtx/type_trait.hpp", "C++", 59, 0, 0, 0, 15, 12, 86
"/Users/goujiayuan/STUDY/图形学算法‼️/tiny-engine/third_party/glm/include/glm/gtx/type_trait.inl", "C++", 51, 0, 0, 0, 5, 6, 62
"/Users/goujiayuan/STUDY/图形学算法‼️/tiny-engine/third_party/glm/include/glm/gtx/vec_swizzle.hpp", "C++", 1947, 0, 0, 0, 347, 489, 2783
"/Users/goujiayuan/STUDY/图形学算法‼️/tiny-engine/third_party/glm/include/glm/gtx/vector_angle.hpp", "C++", 22, 0, 0, 0, 26, 10, 58
"/Users/goujiayuan/STUDY/图形学算法‼️/tiny-engine/third_party/glm/include/glm/gtx/vector_angle.inl", "C++", 36, 0, 0, 0, 2, 7, 45
"/Users/goujiayuan/STUDY/图形学算法‼️/tiny-engine/third_party/glm/include/glm/gtx/vector_query.hpp", "C++", 27, 0, 0, 0, 27, 13, 67
"/Users/goujiayuan/STUDY/图形学算法‼️/tiny-engine/third_party/glm/include/glm/gtx/vector_query.inl", "C++", 128, 0, 0, 0, 1, 26, 155
"/Users/goujiayuan/STUDY/图形学算法‼️/tiny-engine/third_party/glm/include/glm/gtx/wrap.hpp", "C++", 16, 0, 0, 0, 15, 7, 38
"/Users/goujiayuan/STUDY/图形学算法‼️/tiny-engine/third_party/glm/include/glm/gtx/wrap.inl", "C++", 3, 0, 0, 0, 1, 3, 7
"/Users/goujiayuan/STUDY/图形学算法‼️/tiny-engine/third_party/glm/include/glm/integer.hpp", "C++", 55, 0, 0, 0, 139, 19, 213
"/Users/goujiayuan/STUDY/图形学算法‼️/tiny-engine/third_party/glm/include/glm/mat2x2.hpp", "C++", 5, 0, 0, 0, 2, 3, 10
"/Users/goujiayuan/STUDY/图形学算法‼️/tiny-engine/third_party/glm/include/glm/mat2x3.hpp", "C++", 5, 0, 0, 0, 2, 3, 10
"/Users/goujiayuan/STUDY/图形学算法‼️/tiny-engine/third_party/glm/include/glm/mat2x4.hpp", "C++", 5, 0, 0, 0, 2, 3, 10
"/Users/goujiayuan/STUDY/图形学算法‼️/tiny-engine/third_party/glm/include/glm/mat3x2.hpp", "C++", 5, 0, 0, 0, 2, 3, 10
"/Users/goujiayuan/STUDY/图形学算法‼️/tiny-engine/third_party/glm/include/glm/mat3x3.hpp", "C++", 5, 0, 0, 0, 2, 2, 9
"/Users/goujiayuan/STUDY/图形学算法‼️/tiny-engine/third_party/glm/include/glm/mat3x4.hpp", "C++", 5, 0, 0, 0, 2, 2, 9
"/Users/goujiayuan/STUDY/图形学算法‼️/tiny-engine/third_party/glm/include/glm/mat4x2.hpp", "C++", 5, 0, 0, 0, 2, 3, 10
"/Users/goujiayuan/STUDY/图形学算法‼️/tiny-engine/third_party/glm/include/glm/mat4x3.hpp", "C++", 5, 0, 0, 0, 2, 2, 9
"/Users/goujiayuan/STUDY/图形学算法‼️/tiny-engine/third_party/glm/include/glm/mat4x4.hpp", "C++", 5, 0, 0, 0, 2, 3, 10
"/Users/goujiayuan/STUDY/图形学算法‼️/tiny-engine/third_party/glm/include/glm/matrix.hpp", "C++", 78, 0, 0, 0, 63, 21, 162
"/Users/goujiayuan/STUDY/图形学算法‼️/tiny-engine/third_party/glm/include/glm/packing.hpp", "C++", 20, 0, 0, 0, 136, 18, 174
"/Users/goujiayuan/STUDY/图形学算法‼️/tiny-engine/third_party/glm/include/glm/simd/common.h", "C++", 197, 0, 0, 0, 11, 33, 241
"/Users/goujiayuan/STUDY/图形学算法‼️/tiny-engine/third_party/glm/include/glm/simd/exponential.h", "C++", 12, 0, 0, 0, 2, 7, 21
"/Users/goujiayuan/STUDY/图形学算法‼️/tiny-engine/third_party/glm/include/glm/simd/geometric.h", "C++", 105, 0, 0, 0, 2, 18, 125
"/Users/goujiayuan/STUDY/图形学算法‼️/tiny-engine/third_party/glm/include/glm/simd/integer.h", "C++", 63, 0, 0, 0, 29, 24, 116
"/Users/goujiayuan/STUDY/图形学算法‼️/tiny-engine/third_party/glm/include/glm/simd/matrix.h", "C++", 546, 0, 0, 0, 310, 173, 1029
"/Users/goujiayuan/STUDY/图形学算法‼️/tiny-engine/third_party/glm/include/glm/simd/neon.h", "C++", 144, 0, 0, 0, 2, 10, 156
"/Users/goujiayuan/STUDY/图形学算法‼️/tiny-engine/third_party/glm/include/glm/simd/packing.h", "C++", 3, 0, 0, 0, 2, 4, 9
"/Users/goujiayuan/STUDY/图形学算法‼️/tiny-engine/third_party/glm/include/glm/simd/platform.h", "C++", 343, 0, 0, 0, 21, 35, 399
"/Users/goujiayuan/STUDY/图形学算法‼️/tiny-engine/third_party/glm/include/glm/simd/trigonometric.h", "C++", 3, 0, 0, 0, 2, 5, 10
"/Users/goujiayuan/STUDY/图形学算法‼️/tiny-engine/third_party/glm/include/glm/simd/vector_relational.h", "C++", 3, 0, 0, 0, 2, 4, 9
"/Users/goujiayuan/STUDY/图形学算法‼️/tiny-engine/third_party/glm/include/glm/trigonometric.hpp", "C++", 37, 0, 0, 0, 153, 21, 211
"/Users/goujiayuan/STUDY/图形学算法‼️/tiny-engine/third_party/glm/include/glm/vec2.hpp", "C++", 11, 0, 0, 0, 2, 2, 15
"/Users/goujiayuan/STUDY/图形学算法‼️/tiny-engine/third_party/glm/include/glm/vec3.hpp", "C++", 11, 0, 0, 0, 2, 2, 15
"/Users/goujiayuan/STUDY/图形学算法‼️/tiny-engine/third_party/glm/include/glm/vec4.hpp", "C++", 11, 0, 0, 0, 2, 3, 16
"/Users/goujiayuan/STUDY/图形学算法‼️/tiny-engine/third_party/glm/include/glm/vector_relational.hpp", "C++", 25, 0, 0, 0, 82, 15, 122
"/Users/goujiayuan/STUDY/图形学算法‼️/tiny-engine/third_party/imgui/README.md", "Markdown", 0, 0, 2, 0, 0, 1, 3
"/Users/goujiayuan/STUDY/图形学算法‼️/tiny-engine/third_party/imgui/imconfig.h", "C++", 1, 0, 0, 0, 108, 21, 130
"/Users/goujiayuan/STUDY/图形学算法‼️/tiny-engine/third_party/imgui/imgui.cpp", "C++", 10729, 0, 0, 0, 2713, 1523, 14965
"/Users/goujiayuan/STUDY/图形学算法‼️/tiny-engine/third_party/imgui/imgui.h", "C++", 2031, 0, 0, 0, 880, 299, 3210
"/Users/goujiayuan/STUDY/图形学算法‼️/tiny-engine/third_party/imgui/imgui_demo.cpp", "C++", 6541, 0, 0, 0, 887, 744, 8172
"/Users/goujiayuan/STUDY/图形学算法‼️/tiny-engine/third_party/imgui/imgui_draw.cpp", "C++", 3362, 0, 0, 0, 436, 435, 4233
"/Users/goujiayuan/STUDY/图形学算法‼️/tiny-engine/third_party/imgui/imgui_impl_glfw.cpp", "C++", 594, 0, 0, 0, 122, 82, 798
"/Users/goujiayuan/STUDY/图形学算法‼️/tiny-engine/third_party/imgui/imgui_impl_glfw.h", "C++", 22, 0, 0, 0, 19, 10, 51
"/Users/goujiayuan/STUDY/图形学算法‼️/tiny-engine/third_party/imgui/imgui_impl_opengl3.cpp", "C++", 666, 0, 0, 0, 184, 93, 943
"/Users/goujiayuan/STUDY/图形学算法‼️/tiny-engine/third_party/imgui/imgui_impl_opengl3.h", "C++", 24, 0, 0, 0, 27, 13, 64
"/Users/goujiayuan/STUDY/图形学算法‼️/tiny-engine/third_party/imgui/imgui_impl_opengl3_loader.h", "C++", 678, 0, 0, 0, 89, 43, 810
"/Users/goujiayuan/STUDY/图形学算法‼️/tiny-engine/third_party/imgui/imgui_internal.h", "C++", 2513, 0, 0, 0, 471, 352, 3336
"/Users/goujiayuan/STUDY/图形学算法‼️/tiny-engine/third_party/imgui/imgui_tables.cpp", "C++", 2781, 0, 0, 0, 907, 454, 4142
"/Users/goujiayuan/STUDY/图形学算法‼️/tiny-engine/third_party/imgui/imgui_widgets.cpp", "C++", 6528, 0, 0, 0, 1107, 1003, 8638
"/Users/goujiayuan/STUDY/图形学算法‼️/tiny-engine/third_party/imgui/imstb_rectpack.h", "C++", 324, 0, 0, 0, 229, 75, 628
"/Users/goujiayuan/STUDY/图形学算法‼️/tiny-engine/third_party/imgui/imstb_textedit.h", "C++", 808, 0, 0, 0, 463, 167, 1438
"/Users/goujiayuan/STUDY/图形学算法‼️/tiny-engine/third_party/imgui/imstb_truetype.h", "C++", 3485, 0, 0, 0, 1010, 591, 5086
"/Users/goujiayuan/STUDY/图形学算法‼️/tiny-engine/third_party/stb_image/include/stb_image.h", "C++", 5842, 0, 0, 0, 1285, 861, 7988
"/Users/goujiayuan/STUDY/图形学算法‼️/tiny-engine/third_party/stb_image/include/stb_image_write.h", "C++", 1242, 0, 0, 0, 315, 168, 1725
"/Users/goujiayuan/STUDY/图形学算法‼️/tiny-engine/third_party/stb_image/src/stb_image_impl.cpp", "C++", 4, 0, 0, 0, 0, 0, 4
"/Users/goujiayuan/STUDY/图形学算法‼️/tiny-engine/third_party/tinyobjloader/include/tiny_obj_loader.h", "C++", 2396, 0, 0, 0, 533, 530, 3459
"/Users/goujiayuan/STUDY/图形学算法‼️/tiny-engine/随记/半透明物体渲染.md", "Markdown", 0, 0, 26, 0, 0, 17, 43
"/Users/goujiayuan/STUDY/图形学算法‼️/tiny-engine/随记/带宽.md", "Markdown", 0, 0, 18, 0, 0, 9, 27
"Total", "-", 94292, 128, 97, 1069, 30628, 18302, 144516